NO ./sprites/wall.png
SO ./sprites/bricks.png
WE ./sprites/glass.png
EA ./sprites/gemov1.png

F 220,100,0
C 225,100,0

1111111111
1010000001
1010000001
1010000001
1E00000001
1000010001
1000000001
1111111111
