NO ./sprites/wall.png
SO ./sprites/bricks.png
WE ./sprites/glass.png
EA ./sprites/gemov1.png


C 225,137,64

F 220,84,15


            1111111111
            1000000001
            1000000001
            1000000001
            1000000001
            1000000001
            1000000001
11111111111110000000011111111111111
10000000000000000000000000000000001
10000000000000000000000000000000001
10000000000000000000000000000000001
10000000000000000000000000000000001
11111111111110000000011111111111111
            1000000001
            1000000001
            1000000001
            1000000001
            1000000001
            1000000001
            1111111111